tipo_evento,lugar,capacidad,precio_medio,evento_gratuito,distrito,asistentes,hombres,mujeres,ratio_ocupacion
Música,Sala BBK,1237,48.59,0,Casco Viejo,669,316,353,54.08245755860954
Poesía,La Fundición,755,13.0,0,San Francisco,507,246,261,67.1523178807947
Música,Teatro Arriaga,113,29.74,1,Deusto,62,37,25,54.86725663716814
Danza,La Fundición,840,26.4,1,Casco Viejo,528,282,246,62.857142857142854
Poesía,Sala BBK,1146,45.95,1,Casco Viejo,883,444,439,77.05061082024433
Danza,La Fundición,1989,6.07,1,Abando,1544,774,770,77.62694821518352
Música,Teatro Arriaga,1369,14.76,1,Abando,961,564,397,70.1972242512783
Teatro,Bilborock,368,15.92,1,San Francisco,256,132,124,69.56521739130434
Danza,Bilborock,1836,6.48,0,Indautxu,1175,528,647,63.99782135076253
Danza,Bilborock,1695,47.3,0,Casco Viejo,1496,685,811,88.25958702064896
Poesía,Sala BBK,526,22.72,0,Indautxu,340,138,202,64.63878326996198
Poesía,Euskalduna,731,20.88,1,Casco Viejo,376,215,161,51.43638850889193
Música,Teatro Arriaga,539,35.57,0,Abando,277,123,154,51.39146567717996
Música,Teatro Arriaga,729,41.33,0,Abando,462,188,274,63.37448559670782
Música,La Fundición,1919,35.51,1,Deusto,924,547,377,48.15007816571131
Danza,Sala BBK,570,30.56,1,Casco Viejo,306,136,170,53.68421052631579
Danza,La Fundición,637,47.14,0,Abando,539,323,216,84.61538461538461
Teatro,Teatro Arriaga,169,34.53,0,Casco Viejo,99,52,47,58.57988165680473
Danza,Euskalduna,1065,29.04,1,Deusto,802,364,438,75.30516431924883
Teatro,La Fundición,691,46.45,0,Deusto,494,230,264,71.49059334298119
Poesía,La Fundición,290,37.08,0,Abando,190,106,84,65.51724137931035
Danza,La Fundición,235,35.51,1,Indautxu,135,60,75,57.446808510638306
Danza,Sala BBK,1639,5.02,0,Casco Viejo,1474,643,831,89.93288590604027
Poesía,Euskalduna,1201,40.13,1,Indautxu,670,283,387,55.786844296419645
Teatro,Teatro Arriaga,979,33.4,0,Indautxu,728,404,324,74.36159346271705
Teatro,Sala BBK,1956,21.79,0,Indautxu,1476,809,667,75.4601226993865
Danza,Euskalduna,884,36.26,0,Deusto,394,221,173,44.57013574660634
Poesía,Euskalduna,1863,15.77,0,Indautxu,1075,613,462,57.702630166398286
Teatro,Teatro Arriaga,1491,10.62,1,San Francisco,1085,543,542,72.76995305164318
Música,Teatro Arriaga,945,5.63,1,Indautxu,424,244,180,44.86772486772487
Teatro,Bilborock,491,21.52,1,Deusto,295,121,174,60.08146639511202
Teatro,La Fundición,169,19.75,0,Deusto,149,80,69,88.16568047337277
Danza,La Fundición,1068,46.68,1,San Francisco,747,309,438,69.9438202247191
Música,La Fundición,110,29.29,0,Indautxu,82,34,48,74.54545454545455
Música,Euskalduna,158,26.62,0,Casco Viejo,112,57,55,70.88607594936708
Poesía,Euskalduna,723,19.49,0,Abando,316,169,147,43.706777316735824
Teatro,Bilborock,409,45.32,0,Casco Viejo,326,138,188,79.70660146699267
Poesía,Bilborock,1887,13.49,0,San Francisco,1694,747,947,89.77212506624271
Poesía,La Fundición,837,36.07,1,Casco Viejo,354,190,164,42.29390681003584
Danza,Teatro Arriaga,257,31.12,0,Casco Viejo,202,100,102,78.59922178988327
Danza,Sala BBK,645,27.65,0,Deusto,560,316,244,86.82170542635659
Música,Sala BBK,611,31.87,1,Abando,253,127,126,41.4075286415712
Teatro,La Fundición,1185,7.3,1,Indautxu,708,340,368,59.74683544303797
Teatro,Euskalduna,763,28.57,0,Abando,471,278,193,61.730013106159895
Teatro,Bilborock,156,25.33,1,San Francisco,73,31,42,46.794871794871796
Teatro,La Fundición,1983,6.11,1,Deusto,1128,500,628,56.88350983358548
Danza,Euskalduna,674,8.31,1,San Francisco,570,285,285,84.56973293768546
Teatro,Teatro Arriaga,1861,11.11,0,Deusto,1412,574,838,75.87318645889307
Teatro,Sala BBK,1949,44.53,1,Casco Viejo,1172,692,480,60.13340174448435
Música,Sala BBK,565,33.98,0,Abando,391,169,222,69.20353982300885
Poesía,La Fundición,1220,14.1,0,Indautxu,1058,623,435,86.72131147540983
Danza,La Fundición,117,14.58,1,San Francisco,60,35,25,51.28205128205128
Música,Teatro Arriaga,1415,35.85,0,Abando,664,273,391,46.92579505300353
Teatro,Euskalduna,929,23.88,0,Abando,723,371,352,77.82561894510226
Teatro,Bilborock,1765,41.18,0,Indautxu,1273,630,643,72.12464589235128
Teatro,Sala BBK,1747,35.32,0,Casco Viejo,958,385,573,54.836863194046934
Danza,Teatro Arriaga,1053,7.48,0,San Francisco,526,255,271,49.952516619183285
Poesía,La Fundición,285,17.81,1,San Francisco,136,65,71,47.719298245614034
Teatro,La Fundición,1159,13.84,0,Casco Viejo,919,425,494,79.29249352890423
Poesía,Bilborock,515,15.15,1,San Francisco,242,129,113,46.990291262135926
Teatro,Euskalduna,1124,11.03,0,Abando,711,368,343,63.25622775800712
Danza,Euskalduna,101,23.09,0,Indautxu,50,25,25,49.504950495049506
Danza,Bilborock,1310,12.26,1,Abando,940,540,400,71.7557251908397
Teatro,La Fundición,686,46.54,1,Deusto,317,176,141,46.20991253644315
Poesía,Teatro Arriaga,737,46.22,0,Casco Viejo,550,316,234,74.6268656716418
Danza,Bilborock,917,14.61,1,Abando,583,293,290,63.576881134133046
Teatro,Teatro Arriaga,1705,22.09,0,San Francisco,1384,663,721,81.17302052785924
Danza,Teatro Arriaga,1863,21.07,1,Indautxu,1243,743,500,66.72034353193773
Poesía,Teatro Arriaga,403,15.48,0,San Francisco,353,176,177,87.59305210918114
Poesía,La Fundición,1398,14.17,0,Abando,973,529,444,69.5994277539342
Teatro,Sala BBK,1087,46.73,0,Abando,500,233,267,45.998160073597056
Teatro,Euskalduna,1696,31.31,1,Indautxu,1164,470,694,68.63207547169812
Poesía,Sala BBK,937,24.66,0,San Francisco,491,207,284,52.40128068303095
Poesía,Bilborock,1344,13.34,0,Deusto,894,476,418,66.51785714285714
Música,Sala BBK,951,15.05,0,Abando,439,200,239,46.16193480546793
Música,Euskalduna,916,38.0,0,Indautxu,768,342,426,83.84279475982532
Teatro,La Fundición,545,33.34,0,San Francisco,403,180,223,73.94495412844037
Danza,Teatro Arriaga,1464,7.3,0,Deusto,620,257,363,42.349726775956285
Danza,Bilborock,422,36.99,0,Abando,335,198,137,79.38388625592417
Danza,Sala BBK,344,26.17,1,San Francisco,289,168,121,84.01162790697676
Teatro,Sala BBK,548,10.03,1,Casco Viejo,304,170,134,55.47445255474452
Danza,Bilborock,962,39.36,1,Abando,675,365,310,70.16632016632016
Música,Euskalduna,613,33.89,0,Casco Viejo,546,289,257,89.07014681892332
Música,Teatro Arriaga,459,46.21,0,San Francisco,410,210,200,89.32461873638344
Danza,Teatro Arriaga,935,18.54,0,Indautxu,409,203,206,43.74331550802139
Danza,Bilborock,146,9.7,1,Casco Viejo,66,28,38,45.20547945205479
Danza,Teatro Arriaga,162,17.89,0,Indautxu,114,57,57,70.37037037037037
Música,Sala BBK,899,14.94,1,Indautxu,369,219,150,41.045606229143495
Poesía,Bilborock,881,41.17,1,Indautxu,431,201,230,48.9216799091941
Danza,Bilborock,152,36.81,0,Indautxu,62,35,27,40.78947368421053
Danza,Bilborock,135,17.43,1,Deusto,116,65,51,85.92592592592592
Música,Euskalduna,138,19.96,0,Deusto,93,53,40,67.3913043478261
Música,Euskalduna,1079,7.08,1,Abando,774,365,409,71.73308619091752
Teatro,Bilborock,1627,6.2,0,Indautxu,762,382,380,46.83466502765827
Poesía,Teatro Arriaga,1986,14.28,0,Casco Viejo,1043,423,620,52.51762336354482
Poesía,La Fundición,1238,38.0,0,Indautxu,1001,517,484,80.8562197092084
Danza,Euskalduna,1871,27.72,0,Deusto,1681,744,937,89.84500267236771
Danza,Sala BBK,1046,12.02,0,Deusto,860,485,375,82.21797323135756
Teatro,Sala BBK,1108,31.79,0,Deusto,979,510,469,88.35740072202167
Teatro,Sala BBK,440,21.54,0,Abando,202,115,87,45.909090909090914
Música,La Fundición,706,9.43,0,Indautxu,444,242,202,62.889518413597735
Danza,Teatro Arriaga,1704,24.88,0,Indautxu,921,536,385,54.04929577464789
Música,Bilborock,958,34.78,1,Casco Viejo,724,406,318,75.5741127348643
Poesía,Bilborock,793,8.76,1,Casco Viejo,690,371,319,87.01134930643127
Música,La Fundición,658,36.62,1,Casco Viejo,425,178,247,64.58966565349544
Teatro,La Fundición,250,10.65,0,San Francisco,211,123,88,84.39999999999999
Danza,Teatro Arriaga,444,11.45,1,Deusto,394,221,173,88.73873873873875
Música,Teatro Arriaga,1054,27.43,1,Indautxu,683,334,349,64.80075901328273
Música,Sala BBK,234,11.39,1,Indautxu,152,87,65,64.95726495726495
Música,La Fundición,191,21.19,1,Casco Viejo,142,65,77,74.3455497382199
Poesía,Euskalduna,670,25.97,0,Deusto,291,133,158,43.43283582089552
Teatro,La Fundición,1174,7.94,0,Abando,1018,587,431,86.71209540034071
Teatro,Euskalduna,1410,5.7,0,San Francisco,1050,604,446,74.46808510638297
Danza,Sala BBK,978,41.56,0,Indautxu,823,477,346,84.15132924335379
Música,La Fundición,1215,39.0,1,Deusto,609,346,263,50.123456790123456
Música,Sala BBK,586,12.21,0,Indautxu,316,134,182,53.92491467576792
Teatro,Teatro Arriaga,660,30.65,0,Casco Viejo,335,197,138,50.75757575757576
Teatro,Bilborock,981,6.44,1,Casco Viejo,766,316,450,78.0835881753313
Música,Euskalduna,1077,19.0,1,Casco Viejo,901,407,494,83.65831012070566
Danza,Bilborock,524,46.84,0,San Francisco,446,224,222,85.1145038167939
Danza,Teatro Arriaga,1793,5.3,0,Casco Viejo,1046,443,603,58.337981037367534
Danza,La Fundición,1971,10.09,0,Deusto,1663,868,795,84.3734145104008
Teatro,Teatro Arriaga,486,14.0,1,Casco Viejo,260,112,148,53.49794238683128
Danza,Teatro Arriaga,303,39.9,0,Abando,214,125,89,70.62706270627062
Música,La Fundición,1924,42.37,1,Deusto,1127,669,458,58.57588357588358
Danza,La Fundición,1397,41.74,0,Abando,919,374,545,65.78382247673586
Danza,Sala BBK,742,45.77,0,Abando,543,254,289,73.18059299191376
Música,Sala BBK,392,31.78,0,Abando,257,143,114,65.56122448979592
Teatro,La Fundición,754,49.33,0,San Francisco,381,206,175,50.53050397877984
Teatro,Sala BBK,1826,49.24,0,San Francisco,1160,623,537,63.52683461117196
Danza,La Fundición,1463,27.15,0,San Francisco,977,503,474,66.78058783321941
Teatro,Teatro Arriaga,283,46.76,0,San Francisco,244,114,130,86.21908127208481
Poesía,Euskalduna,1160,46.97,1,Abando,1028,458,570,88.62068965517241
Música,Teatro Arriaga,1194,9.62,0,Deusto,924,443,481,77.38693467336684
Danza,Bilborock,662,29.16,0,Deusto,339,165,174,51.20845921450151
Poesía,Euskalduna,1198,31.42,0,Indautxu,943,475,468,78.71452420701168
Música,Bilborock,1111,29.43,0,Abando,698,350,348,62.82628262826283
Música,Teatro Arriaga,1845,29.73,0,Deusto,1446,839,607,78.3739837398374
Poesía,La Fundición,1826,26.79,1,San Francisco,989,532,457,54.16210295728368
Danza,Teatro Arriaga,1830,22.74,0,Casco Viejo,1152,587,565,62.95081967213115
Poesía,La Fundición,753,17.35,1,Indautxu,621,259,362,82.47011952191235
Poesía,Sala BBK,490,36.0,0,Indautxu,432,246,186,88.16326530612245
Teatro,Sala BBK,141,21.74,0,Deusto,115,47,68,81.56028368794325
Danza,Teatro Arriaga,1956,11.12,1,San Francisco,854,507,347,43.66053169734151
Poesía,Euskalduna,375,40.59,1,Indautxu,187,99,88,49.86666666666667
Música,Teatro Arriaga,1042,21.43,0,Indautxu,579,268,311,55.5662188099808
Teatro,Sala BBK,1557,43.32,0,Casco Viejo,809,399,410,51.95889531149647
Música,La Fundición,513,48.81,1,San Francisco,380,164,216,74.07407407407408
Danza,Teatro Arriaga,969,37.48,0,San Francisco,770,444,326,79.46336429308566
Poesía,Teatro Arriaga,1248,45.13,0,Deusto,772,335,437,61.858974358974365
Poesía,Sala BBK,465,10.92,0,Indautxu,396,186,210,85.16129032258064
Teatro,Bilborock,375,28.36,0,Indautxu,335,170,165,89.33333333333333
Poesía,Sala BBK,1843,42.7,0,Indautxu,1493,608,885,81.00922409115573
Poesía,Euskalduna,1365,6.53,0,San Francisco,1023,487,536,74.94505494505495
Teatro,Bilborock,526,5.01,1,Abando,376,207,169,71.48288973384031
Poesía,La Fundición,1882,29.28,0,Indautxu,1417,802,615,75.29224229543038
Teatro,Euskalduna,809,12.06,0,Deusto,421,242,179,52.03955500618047
Teatro,Teatro Arriaga,1316,7.46,1,San Francisco,737,404,333,56.00303951367781
Poesía,Bilborock,1689,38.3,0,Abando,1389,757,632,82.2380106571936
Teatro,Sala BBK,575,7.97,0,San Francisco,265,154,111,46.08695652173913
Danza,Euskalduna,1240,44.4,1,Indautxu,1092,484,608,88.06451612903226
Música,Teatro Arriaga,277,27.37,0,Indautxu,167,89,78,60.28880866425993
Danza,La Fundición,1936,48.52,0,San Francisco,1663,835,828,85.89876033057851
Teatro,Teatro Arriaga,1532,8.38,0,Abando,749,441,308,48.89033942558746
Poesía,Sala BBK,1255,17.94,1,Deusto,1127,455,672,89.80079681274901
Música,Bilborock,791,8.96,0,Abando,664,329,335,83.94437420986094
Música,La Fundición,1567,8.33,0,Casco Viejo,1065,582,483,67.96426292278238
Poesía,La Fundición,894,42.16,0,Deusto,704,320,384,78.74720357941834
Poesía,Bilborock,1407,20.37,0,Indautxu,898,481,417,63.82373845060412
Danza,Sala BBK,893,26.09,0,Indautxu,363,176,187,40.6494960806271
Música,Bilborock,1432,18.94,0,Abando,1204,619,585,84.07821229050279
Teatro,La Fundición,1254,24.18,1,San Francisco,1054,525,529,84.05103668261563
Teatro,Sala BBK,1412,23.4,0,Casco Viejo,900,383,517,63.73937677053825
Teatro,Bilborock,989,11.44,0,Deusto,767,371,396,77.5530839231547
Música,Teatro Arriaga,1682,25.62,1,Indautxu,1325,682,643,78.77526753864447
Teatro,Euskalduna,437,28.84,0,Deusto,329,184,145,75.28604118993135
Música,Sala BBK,270,19.35,1,San Francisco,241,98,143,89.25925925925927
Música,Bilborock,784,48.58,1,Deusto,549,269,280,70.02551020408163
Danza,Teatro Arriaga,193,38.1,0,San Francisco,128,62,66,66.32124352331607
Poesía,Bilborock,1529,27.17,0,Indautxu,788,417,371,51.53695225637671
Poesía,Sala BBK,320,5.06,0,Casco Viejo,135,77,58,42.1875
Teatro,La Fundición,630,12.64,1,Casco Viejo,552,268,284,87.61904761904762
Teatro,Sala BBK,672,5.3,0,Indautxu,300,136,164,44.642857142857146
Poesía,Bilborock,1432,12.98,0,Abando,686,394,292,47.90502793296089
Danza,Bilborock,648,18.1,0,Deusto,407,177,230,62.808641975308646
Música,La Fundición,905,25.47,1,Indautxu,480,223,257,53.03867403314917
Teatro,Teatro Arriaga,1862,24.35,1,Deusto,959,423,536,51.50375939849624
Poesía,La Fundición,1380,9.92,1,Deusto,637,334,303,46.15942028985508
Música,Bilborock,1301,7.69,0,Casco Viejo,604,346,258,46.425826287471175
Teatro,La Fundición,1618,5.76,0,Indautxu,1218,540,678,75.27812113720643
Danza,Teatro Arriaga,1000,38.9,1,Abando,755,382,373,75.5
Danza,Sala BBK,1137,19.18,1,Indautxu,736,404,332,64.73175021987687
Teatro,Euskalduna,243,22.87,0,Deusto,213,98,115,87.65432098765432
Danza,Sala BBK,1256,21.53,0,San Francisco,786,469,317,62.57961783439491
Poesía,Euskalduna,1200,39.48,1,San Francisco,1049,612,437,87.41666666666667
Teatro,Bilborock,301,31.0,0,Deusto,243,142,101,80.73089700996677
Música,La Fundición,224,37.83,1,Deusto,186,91,95,83.03571428571429
Danza,La Fundición,1256,37.08,0,Casco Viejo,889,442,447,70.78025477707006
Teatro,Bilborock,1501,6.23,1,Casco Viejo,842,441,401,56.095936042638236
Teatro,Bilborock,135,9.07,0,Deusto,63,34,29,46.666666666666664
Música,Sala BBK,1637,9.13,0,San Francisco,1216,710,506,74.282223579719
Teatro,La Fundición,1752,35.8,0,Casco Viejo,1449,746,703,82.7054794520548
Danza,Bilborock,437,16.39,1,Deusto,256,106,150,58.58123569794051
Poesía,Teatro Arriaga,455,13.09,0,San Francisco,359,144,215,78.9010989010989
Poesía,Sala BBK,705,41.64,0,Abando,421,239,182,59.716312056737586
Teatro,Bilborock,1894,25.61,1,Deusto,1092,565,527,57.655755015839496
Teatro,Euskalduna,168,9.83,0,Deusto,109,62,47,64.88095238095238
Poesía,Teatro Arriaga,935,25.94,1,San Francisco,831,476,355,88.87700534759358
Danza,Bilborock,1088,23.84,1,San Francisco,869,498,371,79.87132352941177
Teatro,Sala BBK,1334,38.88,0,Indautxu,1183,555,628,88.68065967016491
Danza,Sala BBK,1837,21.95,0,Abando,753,337,416,40.99074578116495
Danza,Sala BBK,1719,31.89,0,Casco Viejo,1316,630,686,76.55613728912158
Música,Bilborock,580,35.94,0,San Francisco,470,219,251,81.03448275862068
Poesía,Euskalduna,1322,40.55,1,Indautxu,775,327,448,58.6232980332829
Música,Euskalduna,875,19.17,1,Deusto,750,399,351,85.71428571428571
Teatro,Bilborock,1096,41.51,0,San Francisco,459,207,252,41.87956204379562
Danza,Sala BBK,1600,20.95,1,Casco Viejo,1068,576,492,66.75
Poesía,Euskalduna,1147,26.35,0,Casco Viejo,711,305,406,61.987794245858765
Música,Bilborock,1737,33.56,0,Indautxu,971,467,504,55.90097869890616
Música,Sala BBK,1140,28.06,0,San Francisco,1003,596,407,87.98245614035088
Música,Sala BBK,1037,22.63,1,Deusto,910,462,448,87.75313404050145
Danza,Sala BBK,624,33.35,0,Abando,320,167,153,51.28205128205128
Teatro,Teatro Arriaga,1626,7.84,0,Casco Viejo,1102,536,566,67.77367773677737
Música,Teatro Arriaga,115,15.31,0,Deusto,55,26,29,47.82608695652174
Música,La Fundición,870,27.25,1,Casco Viejo,426,248,178,48.96551724137931
Teatro,Teatro Arriaga,1968,6.22,0,Deusto,1096,569,527,55.6910569105691
Poesía,Euskalduna,423,27.55,0,Deusto,331,176,155,78.25059101654847
Poesía,La Fundición,1816,8.99,0,Abando,1607,922,685,88.49118942731278
Teatro,Sala BBK,287,30.29,0,Abando,215,114,101,74.91289198606272
Música,La Fundición,1807,45.55,0,Casco Viejo,1573,903,670,87.05035971223022
Música,Sala BBK,1507,49.91,0,Deusto,1320,702,618,87.59124087591242
Música,Teatro Arriaga,673,25.59,0,Deusto,500,260,240,74.29420505200595
Teatro,La Fundición,1436,8.33,1,San Francisco,834,421,413,58.07799442896936
Música,Bilborock,1867,21.3,0,Abando,981,589,392,52.544188537761116
Poesía,Sala BBK,1015,22.43,1,Abando,550,312,238,54.187192118226605
Música,Teatro Arriaga,1683,46.59,0,Abando,951,428,523,56.50623885918004
Poesía,Teatro Arriaga,552,37.3,0,Abando,376,223,153,68.11594202898551
Música,Bilborock,685,20.76,1,San Francisco,292,127,165,42.627737226277375
Teatro,Euskalduna,127,48.35,0,Abando,103,61,42,81.10236220472441
Danza,La Fundición,1312,38.58,0,Deusto,697,368,329,53.125
Danza,La Fundición,726,5.8,0,San Francisco,311,177,134,42.837465564738295
Teatro,Euskalduna,1333,37.63,0,Abando,626,347,279,46.96174043510878
Poesía,Teatro Arriaga,1316,36.81,1,Indautxu,863,453,410,65.5775075987842
Música,Teatro Arriaga,333,23.74,1,Abando,161,82,79,48.348348348348345
Danza,Bilborock,1433,9.47,0,San Francisco,789,445,344,55.059316120027916
Poesía,Sala BBK,443,10.13,0,San Francisco,337,202,135,76.07223476297969
Poesía,La Fundición,1405,15.22,0,Indautxu,1156,643,513,82.27758007117437
Música,Euskalduna,1545,39.51,0,Deusto,862,439,423,55.79288025889968
Danza,Sala BBK,1572,6.32,0,San Francisco,1076,563,513,68.44783715012723
Danza,Sala BBK,435,32.6,1,Casco Viejo,197,108,89,45.28735632183908
Danza,Teatro Arriaga,904,16.96,0,Indautxu,583,268,315,64.49115044247787
Poesía,La Fundición,1541,18.4,0,San Francisco,903,481,422,58.59831278390656
Poesía,La Fundición,916,28.31,0,Abando,384,223,161,41.92139737991266
Poesía,La Fundición,1392,36.8,0,Abando,595,327,268,42.74425287356322
Danza,Euskalduna,976,27.9,0,Indautxu,827,483,344,84.73360655737704
Teatro,Teatro Arriaga,1025,48.13,1,Casco Viejo,533,235,298,52.0
Teatro,Euskalduna,248,35.0,1,Deusto,115,53,62,46.37096774193548
Danza,Teatro Arriaga,559,27.77,1,San Francisco,493,290,203,88.19320214669052
Danza,Sala BBK,395,48.8,1,Casco Viejo,316,132,184,80.0
Teatro,Teatro Arriaga,1746,36.36,1,San Francisco,905,509,396,51.8327605956472
Música,Teatro Arriaga,1217,49.74,0,Indautxu,578,254,324,47.493837304847986
Música,Bilborock,1075,29.48,0,Indautxu,828,432,396,77.02325581395348
Teatro,Euskalduna,1942,49.29,1,San Francisco,1052,488,564,54.17095777548918
Poesía,Bilborock,608,6.17,0,San Francisco,408,225,183,67.10526315789474
Teatro,Bilborock,874,41.81,0,Casco Viejo,434,217,217,49.65675057208238
Teatro,Teatro Arriaga,1992,44.93,0,Indautxu,1349,763,586,67.72088353413655
Teatro,Teatro Arriaga,1695,37.69,0,Deusto,1503,790,713,88.67256637168141
Poesía,Euskalduna,753,27.31,0,Abando,338,145,193,44.8871181938911
Danza,Teatro Arriaga,1711,49.71,0,Deusto,698,413,285,40.794856808883694
Teatro,Bilborock,516,17.77,0,San Francisco,330,149,181,63.95348837209303
Poesía,Teatro Arriaga,333,13.23,0,Deusto,268,125,143,80.48048048048048
Poesía,La Fundición,1930,36.71,0,Deusto,1241,534,707,64.30051813471502
Música,Teatro Arriaga,517,43.95,0,Deusto,273,143,130,52.804642166344294
Poesía,Euskalduna,1090,19.28,0,Indautxu,514,251,263,47.1559633027523
Teatro,La Fundición,1538,49.59,0,San Francisco,686,294,392,44.60338101430429
Música,La Fundición,1840,7.53,1,San Francisco,1373,780,593,74.6195652173913
Música,Teatro Arriaga,1209,27.19,0,San Francisco,998,562,436,82.5475599669148
Danza,Sala BBK,1896,48.16,0,Indautxu,873,424,449,46.04430379746836
Teatro,Bilborock,1217,27.3,1,Indautxu,926,487,439,76.08874281018899
Danza,Teatro Arriaga,1122,42.38,0,San Francisco,948,499,449,84.49197860962568
Danza,Teatro Arriaga,830,6.16,0,Indautxu,692,369,323,83.37349397590361
Teatro,Euskalduna,1654,11.84,0,Casco Viejo,1201,578,623,72.61185006045949
Poesía,La Fundición,254,38.51,0,Casco Viejo,169,101,68,66.53543307086615
Poesía,Sala BBK,495,7.7,0,Casco Viejo,298,170,128,60.2020202020202
Música,La Fundición,499,7.22,0,Casco Viejo,265,157,108,53.106212424849694
Danza,Sala BBK,1410,36.47,0,Abando,802,430,372,56.87943262411348
Música,Euskalduna,420,27.42,0,Deusto,308,154,154,73.33333333333333
Poesía,Sala BBK,445,21.75,1,Casco Viejo,181,87,94,40.67415730337079
Danza,Sala BBK,1876,13.19,0,Abando,1575,843,732,83.95522388059702
Poesía,Euskalduna,1679,8.57,1,San Francisco,832,464,368,49.55330553901132
Danza,Sala BBK,1300,12.24,0,Deusto,821,373,448,63.153846153846146
Poesía,Sala BBK,1616,30.22,0,San Francisco,1124,649,475,69.55445544554455
Poesía,La Fundición,1426,44.15,1,Abando,841,394,447,58.97615708274895
Poesía,La Fundición,448,24.71,0,Indautxu,216,95,121,48.214285714285715
Teatro,Euskalduna,872,49.06,0,San Francisco,536,284,252,61.46788990825688
Poesía,Teatro Arriaga,599,27.85,1,Indautxu,365,181,184,60.934891485809686
Danza,Euskalduna,1371,13.39,1,Abando,806,339,467,58.7892049598833
Danza,Sala BBK,689,17.89,0,Casco Viejo,383,212,171,55.587808417997095
Poesía,Bilborock,1408,46.7,1,Abando,746,432,314,52.98295454545454
Teatro,La Fundición,475,22.75,1,Casco Viejo,270,122,148,56.84210526315789
Poesía,Bilborock,372,37.71,0,San Francisco,237,99,138,63.70967741935484
Danza,Sala BBK,1637,11.4,1,Indautxu,962,469,493,58.76603543066585
Teatro,Bilborock,1442,38.05,0,San Francisco,1079,479,600,74.82662968099861
Música,Sala BBK,781,24.92,1,San Francisco,437,216,221,55.953905249679906
Poesía,Euskalduna,1977,44.18,0,Abando,908,467,441,45.928174001011634
Danza,Teatro Arriaga,1576,41.9,1,Abando,812,361,451,51.52284263959391
Poesía,Sala BBK,1336,47.16,1,Abando,999,589,410,74.77544910179641
Poesía,La Fundición,1534,45.84,1,Indautxu,735,368,367,47.91395045632334
Poesía,Bilborock,1092,40.63,0,Deusto,616,255,361,56.41025641025641
Poesía,Bilborock,107,12.89,0,San Francisco,54,32,22,50.467289719626166
Teatro,Euskalduna,401,40.95,0,San Francisco,177,71,106,44.13965087281795
Música,Bilborock,1527,7.32,0,Deusto,1240,717,523,81.20497707924034
Danza,La Fundición,897,35.27,0,Deusto,630,300,330,70.23411371237458
Teatro,Bilborock,742,7.87,0,San Francisco,560,264,296,75.47169811320755
Teatro,Euskalduna,564,47.46,0,Deusto,360,209,151,63.829787234042556
Teatro,Sala BBK,422,44.95,0,San Francisco,181,86,95,42.89099526066351
Teatro,Bilborock,1660,23.62,1,Indautxu,1044,595,449,62.89156626506024
Poesía,Teatro Arriaga,1956,45.07,0,Casco Viejo,1324,765,559,67.68916155419224
Música,Bilborock,1869,10.76,0,San Francisco,1581,776,805,84.59069020866774
Teatro,Teatro Arriaga,1388,30.27,0,San Francisco,1225,724,501,88.25648414985591
Danza,Teatro Arriaga,493,31.26,1,Abando,392,183,209,79.5131845841785
Teatro,Bilborock,1441,42.05,1,San Francisco,1023,440,583,70.99236641221374
Teatro,La Fundición,1495,22.97,1,Abando,1138,646,492,76.12040133779264
Música,Sala BBK,186,34.31,1,Deusto,83,34,49,44.623655913978496
Música,Sala BBK,527,34.09,0,Casco Viejo,468,262,206,88.8045540796964
Teatro,Bilborock,1820,24.34,0,Indautxu,1219,638,581,66.97802197802197
Música,Teatro Arriaga,1704,48.78,0,Abando,1505,798,707,88.32159624413146
Poesía,Bilborock,340,32.25,1,Abando,233,114,119,68.52941176470588
Poesía,Euskalduna,1108,6.23,0,Casco Viejo,721,416,305,65.07220216606498
Poesía,Teatro Arriaga,248,19.01,0,Abando,175,91,84,70.56451612903226
Poesía,Sala BBK,228,9.32,0,San Francisco,133,59,74,58.333333333333336
Teatro,Teatro Arriaga,243,15.12,0,Deusto,149,86,63,61.31687242798354
Teatro,Sala BBK,1711,35.11,0,San Francisco,1219,726,493,71.2448860315605
Poesía,Euskalduna,1049,32.77,0,Deusto,875,382,493,83.41277407054338
Danza,Sala BBK,662,43.31,0,Deusto,563,230,333,85.04531722054381
Poesía,Bilborock,128,6.99,0,Abando,59,27,32,46.09375
Poesía,Euskalduna,1546,45.12,0,Abando,918,469,449,59.37904269081501
Danza,La Fundición,1925,39.28,0,San Francisco,1595,662,933,82.85714285714286
Poesía,Teatro Arriaga,1941,9.3,0,San Francisco,1156,599,557,59.55692941782586
Danza,Euskalduna,1293,44.65,0,Deusto,533,220,313,41.22196442382057
Danza,Teatro Arriaga,1247,49.65,1,Deusto,809,406,403,64.8757016840417
Poesía,Teatro Arriaga,619,13.98,0,Casco Viejo,547,290,257,88.36833602584814
Teatro,Bilborock,1145,32.12,0,Indautxu,760,329,431,66.37554585152839
Teatro,Bilborock,439,34.47,0,Indautxu,287,118,169,65.37585421412301
Teatro,Euskalduna,478,11.17,0,Indautxu,420,189,231,87.86610878661088
Danza,Bilborock,1970,28.81,1,Abando,1323,684,639,67.15736040609137
Música,La Fundición,1522,12.08,1,Casco Viejo,1359,571,788,89.2904073587385
Danza,Euskalduna,1086,46.01,0,San Francisco,752,382,370,69.24493554327809
Música,Teatro Arriaga,1938,49.19,0,Indautxu,832,358,474,42.93085655314757
Danza,Teatro Arriaga,1677,15.41,1,Abando,1077,627,450,64.22182468694096
Poesía,Teatro Arriaga,1128,8.41,0,Indautxu,569,259,310,50.443262411347526
Música,La Fundición,1969,41.74,1,Casco Viejo,1581,821,760,80.2945657694261
Danza,Bilborock,1516,17.11,0,Casco Viejo,1189,512,677,78.43007915567283
Música,Bilborock,1952,11.59,0,San Francisco,1484,711,773,76.02459016393442
Teatro,Teatro Arriaga,820,5.89,0,Indautxu,680,298,382,82.92682926829268
Música,Sala BBK,1450,19.8,0,Deusto,863,450,413,59.51724137931035
Teatro,La Fundición,306,37.15,0,Indautxu,209,89,120,68.30065359477125
Poesía,Sala BBK,1170,39.28,1,Casco Viejo,1044,536,508,89.23076923076924
Danza,Teatro Arriaga,1308,35.45,0,San Francisco,1101,552,549,84.17431192660551
Música,Euskalduna,544,39.81,1,Deusto,415,244,171,76.28676470588235
Teatro,La Fundición,129,15.48,1,Casco Viejo,93,56,37,72.09302325581395
Música,Bilborock,858,35.18,1,Abando,735,380,355,85.66433566433567
Poesía,Euskalduna,507,40.21,1,San Francisco,440,233,207,86.78500986193293
Poesía,La Fundición,386,38.52,0,Casco Viejo,342,154,188,88.60103626943005
Música,Bilborock,237,42.79,0,Deusto,175,88,87,73.83966244725738
Música,Sala BBK,870,28.87,0,San Francisco,751,331,420,86.32183908045977
Danza,Bilborock,1215,7.01,1,Abando,685,395,290,56.37860082304527
Danza,Sala BBK,401,41.06,0,Indautxu,351,199,152,87.53117206982543
Música,Sala BBK,931,21.66,0,Indautxu,533,298,235,57.25026852846402
Música,Teatro Arriaga,1728,21.72,0,Abando,978,464,514,56.59722222222222
Poesía,La Fundición,907,45.76,0,Deusto,657,296,361,72.43660418963617
Poesía,Euskalduna,525,40.68,0,Abando,249,142,107,47.42857142857143
Poesía,Bilborock,434,39.51,0,Casco Viejo,308,168,140,70.96774193548387
Poesía,Sala BBK,407,11.21,1,San Francisco,317,164,153,77.88697788697789
Teatro,La Fundición,833,48.75,1,Deusto,714,402,312,85.71428571428571
Poesía,Bilborock,1807,31.26,1,Indautxu,892,422,470,49.36358605423354
Poesía,Euskalduna,1191,5.13,0,Deusto,846,409,437,71.03274559193954
Teatro,Sala BBK,1767,34.56,1,Indautxu,985,538,447,55.74419920769667
Música,Sala BBK,993,43.21,0,Abando,782,436,346,78.75125881168177
Teatro,Teatro Arriaga,817,16.59,1,Deusto,499,299,200,61.07711138310894
Poesía,Euskalduna,447,17.05,0,Abando,250,111,139,55.92841163310962
Teatro,Teatro Arriaga,1167,22.67,1,Casco Viejo,900,517,383,77.12082262210797
Danza,Bilborock,617,26.16,0,Deusto,386,219,167,62.560777957860616
Teatro,Bilborock,275,23.45,0,Abando,233,99,134,84.72727272727273
Teatro,Bilborock,1757,43.25,0,Casco Viejo,943,389,554,53.67103016505407
Danza,Sala BBK,1277,46.98,0,Deusto,1015,550,465,79.48316366483947
Danza,Euskalduna,1778,19.16,0,Deusto,801,469,332,45.05061867266591
Música,Bilborock,1294,20.07,1,Indautxu,1062,601,461,82.07109737248841
Música,Teatro Arriaga,534,8.01,0,Casco Viejo,394,213,181,73.78277153558052
Danza,Bilborock,131,20.45,0,Deusto,98,49,49,74.80916030534351
Teatro,Bilborock,479,11.4,1,Casco Viejo,425,185,240,88.72651356993737
Danza,Euskalduna,1293,36.79,0,Indautxu,732,429,303,56.61252900232019
Danza,Teatro Arriaga,988,24.76,0,San Francisco,654,332,322,66.19433198380567
Música,Bilborock,1732,49.5,0,Indautxu,1323,606,717,76.38568129330254
Teatro,Euskalduna,467,42.12,0,Deusto,229,102,127,49.03640256959314
Poesía,Teatro Arriaga,1582,6.15,0,Casco Viejo,1336,631,705,84.45006321112515
Música,Euskalduna,931,47.32,0,Casco Viejo,710,318,392,76.26208378088077
Música,Sala BBK,1084,19.09,0,Casco Viejo,574,296,278,52.952029520295206
Teatro,Sala BBK,1845,12.26,0,Casco Viejo,947,553,394,51.32791327913279
Poesía,Teatro Arriaga,833,40.02,0,Indautxu,477,281,196,57.262905162064826
Danza,Bilborock,1661,41.0,1,San Francisco,1419,848,571,85.43046357615894
Danza,Euskalduna,1506,49.96,1,Abando,720,386,334,47.808764940239044
Danza,Bilborock,1554,31.4,1,Abando,1255,519,736,80.75933075933077
Música,Teatro Arriaga,1190,41.15,0,Deusto,671,319,352,56.38655462184874
Música,Sala BBK,790,36.01,0,Indautxu,693,344,349,87.72151898734177
Música,La Fundición,1726,33.24,0,Deusto,871,496,375,50.46349942062572
Poesía,La Fundición,1902,7.34,0,Casco Viejo,1691,835,856,88.90641430073607
Poesía,Teatro Arriaga,261,38.62,0,San Francisco,118,54,64,45.21072796934866
Danza,La Fundición,1870,48.7,0,San Francisco,999,407,592,53.42245989304813
Danza,La Fundición,1458,36.61,0,Abando,638,381,257,43.75857338820302
Música,Bilborock,574,24.31,0,Casco Viejo,323,152,171,56.271777003484324
Danza,Bilborock,1379,9.02,0,San Francisco,853,463,390,61.85641769398115
Teatro,Bilborock,1369,8.74,0,Casco Viejo,570,276,294,41.636230825420014
Danza,Bilborock,1658,48.11,0,Indautxu,1310,742,568,79.0108564535585
Música,Euskalduna,940,31.54,1,Abando,544,246,298,57.87234042553191
Música,Bilborock,985,16.71,0,San Francisco,713,327,386,72.38578680203047
Teatro,Bilborock,1973,21.78,1,Abando,1107,556,551,56.10745058286872
Teatro,Teatro Arriaga,1481,31.69,1,Indautxu,837,498,339,56.51586765698852
Poesía,La Fundición,864,48.46,0,Casco Viejo,729,430,299,84.375
Poesía,Sala BBK,340,18.21,0,Abando,159,69,90,46.76470588235294
Teatro,Sala BBK,1903,35.17,0,San Francisco,794,364,430,41.723594324750394
Teatro,La Fundición,1820,35.04,0,Indautxu,1431,698,733,78.62637362637362
Danza,Bilborock,1236,7.02,1,Indautxu,613,352,261,49.59546925566343
Poesía,Sala BBK,1154,43.56,0,Abando,685,318,367,59.35875216637781
Danza,Sala BBK,1993,30.17,1,San Francisco,1491,762,729,74.81184144505771
Danza,Sala BBK,1336,8.07,1,Abando,907,500,407,67.88922155688623
Danza,Euskalduna,1639,26.17,0,Casco Viejo,1348,712,636,82.24527150701647
Teatro,Sala BBK,413,19.51,0,Abando,277,112,165,67.07021791767555
Danza,Bilborock,1935,13.44,0,Abando,873,363,510,45.11627906976744
Danza,Sala BBK,515,45.4,1,Deusto,213,88,125,41.359223300970875
Teatro,Euskalduna,1026,31.18,0,San Francisco,773,460,313,75.3411306042885
Teatro,Euskalduna,1841,39.86,0,San Francisco,1063,431,632,57.74035850081477
Música,La Fundición,338,32.53,1,Abando,260,139,121,76.92307692307693
Danza,La Fundición,1187,14.89,1,Indautxu,641,306,335,54.001684919966294
Danza,La Fundición,500,23.1,0,Indautxu,405,187,218,81.0
Música,Euskalduna,1531,23.17,0,Casco Viejo,856,403,453,55.91116917047682
Teatro,Teatro Arriaga,243,37.36,0,Casco Viejo,215,115,100,88.47736625514403
Teatro,Teatro Arriaga,900,25.02,1,Abando,734,434,300,81.55555555555556
Música,La Fundición,801,21.37,0,San Francisco,509,215,294,63.54556803995006
Teatro,La Fundición,1044,35.33,1,Deusto,788,325,463,75.47892720306514
Danza,La Fundición,1997,26.42,0,Indautxu,1010,504,506,50.57586379569354
Danza,Sala BBK,1245,41.12,0,Deusto,1049,430,619,84.25702811244979
Teatro,La Fundición,231,19.79,0,Casco Viejo,121,53,68,52.38095238095239
Música,Bilborock,815,33.39,0,Casco Viejo,427,189,238,52.392638036809814
Poesía,Bilborock,924,47.32,0,Casco Viejo,638,257,381,69.04761904761905
Música,Teatro Arriaga,409,25.88,0,Casco Viejo,212,120,92,51.83374083129584
Teatro,Sala BBK,817,46.18,0,San Francisco,609,279,330,74.54100367197063
Teatro,Euskalduna,937,15.21,0,Indautxu,456,241,215,48.66595517609392
Poesía,Bilborock,1039,34.49,1,Abando,676,405,271,65.06256015399423
Danza,Sala BBK,454,21.99,0,Indautxu,331,186,145,72.90748898678414
Poesía,Euskalduna,1190,48.12,1,San Francisco,976,395,581,82.01680672268907
Danza,La Fundición,606,41.27,0,Casco Viejo,381,154,227,62.87128712871287
Teatro,Sala BBK,959,11.15,1,Deusto,481,211,270,50.156412930135566
Poesía,La Fundición,1939,16.7,0,Indautxu,807,382,425,41.61939143888602
Música,Sala BBK,1146,15.85,0,Deusto,593,335,258,51.74520069808028
Teatro,Teatro Arriaga,1891,32.21,0,San Francisco,1625,972,653,85.93336858804865
Música,Euskalduna,1822,13.22,1,Indautxu,1211,554,657,66.46542261251372
Poesía,La Fundición,955,27.41,0,Abando,641,336,305,67.12041884816755
Música,Euskalduna,1808,26.92,0,Deusto,1179,690,489,65.21017699115043
Poesía,La Fundición,722,25.57,0,San Francisco,393,159,234,54.43213296398892
Música,Sala BBK,1228,16.64,0,Casco Viejo,518,207,311,42.18241042345277
Teatro,La Fundición,1900,15.67,0,Casco Viejo,815,350,465,42.89473684210526
Danza,Bilborock,1025,10.1,0,Abando,742,396,346,72.39024390243902
Danza,Bilborock,1535,48.09,1,Deusto,1260,623,637,82.08469055374593
Teatro,Teatro Arriaga,990,13.84,1,San Francisco,570,297,273,57.57575757575758
Poesía,Euskalduna,1277,16.8,1,San Francisco,775,319,456,60.68911511354737
Poesía,Sala BBK,1781,46.1,0,Casco Viejo,842,444,398,47.276810780460416
Danza,Euskalduna,1011,31.89,0,Casco Viejo,806,436,370,79.72304648862513
Danza,Sala BBK,1872,16.41,1,Deusto,1262,528,734,67.41452991452992
Poesía,Bilborock,1743,30.07,0,San Francisco,766,413,353,43.947217441193345
Poesía,Sala BBK,1365,11.46,0,Indautxu,781,373,408,57.21611721611721
Música,Bilborock,1319,44.65,1,San Francisco,769,412,357,58.30174374526156
Poesía,Bilborock,700,8.33,0,Deusto,500,232,268,71.42857142857143
Música,Bilborock,911,15.8,0,Abando,663,329,334,72.77716794731064
Danza,Bilborock,179,17.96,0,Casco Viejo,73,40,33,40.78212290502793
Música,La Fundición,459,46.82,0,Abando,276,159,117,60.130718954248366
Poesía,La Fundición,185,46.14,1,San Francisco,81,39,42,43.78378378378379
Música,Bilborock,1406,28.16,0,Abando,746,445,301,53.058321479374115
Música,La Fundición,435,27.25,1,San Francisco,326,195,131,74.94252873563218
Música,Sala BBK,408,47.88,0,San Francisco,179,97,82,43.872549019607845
Poesía,Bilborock,1611,14.11,1,Indautxu,1389,647,742,86.21973929236499
Danza,La Fundición,1891,8.59,0,Indautxu,1088,501,587,57.53569539925966
Teatro,Bilborock,1829,34.07,0,Casco Viejo,1124,663,461,61.45434663750683
Música,Bilborock,1201,34.17,0,Deusto,914,519,395,76.10324729392173
Música,Bilborock,864,26.83,0,San Francisco,366,163,203,42.36111111111111
Danza,Bilborock,1743,18.06,1,Casco Viejo,1475,644,831,84.62421113023522
Teatro,Euskalduna,118,11.35,1,Casco Viejo,50,25,25,42.3728813559322
Danza,Teatro Arriaga,1158,27.53,0,Deusto,487,235,252,42.05526770293609
Poesía,Sala BBK,1387,37.16,0,Abando,682,327,355,49.170872386445566
Teatro,Euskalduna,796,29.36,1,Deusto,552,316,236,69.34673366834171
Música,Euskalduna,158,17.87,1,Casco Viejo,141,72,69,89.24050632911393
Poesía,Euskalduna,536,5.76,0,Abando,439,188,251,81.90298507462687
Teatro,La Fundición,975,33.13,1,Deusto,713,352,361,73.12820512820512
Poesía,La Fundición,1728,25.65,1,San Francisco,1088,558,530,62.96296296296296
Música,La Fundición,812,18.41,1,Casco Viejo,702,286,416,86.45320197044335
Danza,La Fundición,1966,38.05,0,Indautxu,1521,846,675,77.36520854526958
Danza,Sala BBK,364,12.97,0,Indautxu,197,95,102,54.12087912087912
Danza,La Fundición,832,10.69,1,San Francisco,428,252,176,51.442307692307686
Música,Euskalduna,970,7.27,0,Abando,842,417,425,86.80412371134021
Poesía,La Fundición,1165,14.19,1,Casco Viejo,980,455,525,84.12017167381974
Teatro,Pabellón Número 6,1527,58.42,1,Casco Viejo,1225,583,642,80.2226588081205
Concierto,Filarmónica de Bilbao,1664,33.24,0,Abando,828,461,367,49.75961538461539
Teatro,Teatro Campos Elíseos,839,28.72,1,Indautxu,398,166,232,47.43742550655543
Teatro,Pabellón Número 6,1686,47.2,0,Casco Viejo,750,320,430,44.48398576512456
Teatro,Pabellón Número 6,856,20.26,0,Deusto,390,225,165,45.5607476635514
Monólogo,Teatro Campos Elíseos,1611,25.08,0,Indautxu,659,352,307,40.90626939788951
Teatro,Pabellón Número 6,1461,23.4,0,San Francisco,618,351,267,42.299794661190965
Teatro,Pabellón Número 6,714,42.31,0,Abando,608,291,317,85.15406162464986
Teatro,Pabellón Número 6,905,20.74,0,San Francisco,669,307,362,73.92265193370166
Musical,Teatro Campos Elíseos,931,10.41,0,Abando,572,279,293,61.43931256713212
Teatro,Pabellón Número 6,1023,30.01,0,Deusto,467,269,198,45.650048875855326
Musical,Teatro Campos Elíseos,1337,34.54,0,Deusto,1193,483,710,89.22961854899027
Teatro,Pabellón Número 6,980,15.61,1,Casco Viejo,533,241,292,54.38775510204081
Concierto,Filarmónica de Bilbao,802,19.5,1,Casco Viejo,467,265,202,58.22942643391521
Teatro,Pabellón Número 6,1547,18.62,0,Casco Viejo,1336,682,654,86.36069812540401
Monólogo,Teatro Campos Elíseos,700,26.72,1,Abando,311,137,174,44.42857142857143
Concierto,Filarmónica de Bilbao,419,21.57,1,Indautxu,247,140,107,58.94988066825776
Teatro,Pabellón Número 6,1612,21.86,1,Indautxu,956,440,516,59.30521091811415
Concierto,Filarmónica de Bilbao,522,57.07,1,Casco Viejo,303,138,165,58.04597701149425
Concierto,Filarmónica de Bilbao,970,37.66,0,Deusto,633,365,268,65.25773195876289
Musical,Teatro Campos Elíseos,220,52.46,0,Indautxu,131,70,61,59.54545454545455
Concierto,Filarmónica de Bilbao,265,15.85,1,San Francisco,128,74,54,48.301886792452834
Teatro,Pabellón Número 6,1209,38.84,0,Casco Viejo,872,449,423,72.12572373862697
Monólogo,Teatro Campos Elíseos,856,31.31,0,Abando,373,163,210,43.574766355140184
Musical,Teatro Campos Elíseos,1186,54.3,0,Indautxu,768,428,340,64.75548060708263
Concierto,Filarmónica de Bilbao,624,40.09,0,Abando,460,218,242,73.71794871794873
Musical,Teatro Campos Elíseos,1357,36.43,0,San Francisco,1154,467,687,85.04053058216654
Concierto,Filarmónica de Bilbao,505,27.87,0,Casco Viejo,343,178,165,67.92079207920793
Teatro,Pabellón Número 6,476,46.48,0,Casco Viejo,242,105,137,50.84033613445378
Teatro,Pabellón Número 6,846,40.82,0,Deusto,678,277,401,80.1418439716312
Concierto,Filarmónica de Bilbao,1639,25.74,0,Abando,941,560,381,57.4130567419158
Teatro,Pabellón Número 6,604,52.78,0,Abando,428,180,248,70.86092715231787
Concierto,Filarmónica de Bilbao,1620,30.66,0,Deusto,879,363,516,54.25925925925926
Teatro,Pabellón Número 6,1450,31.87,0,Indautxu,1002,420,582,69.10344827586206
Teatro,Teatro Campos Elíseos,548,23.09,0,Indautxu,367,160,207,66.97080291970804
Concierto,Filarmónica de Bilbao,1385,50.77,1,Deusto,792,415,377,57.18411552346571
Teatro,Teatro Campos Elíseos,355,45.33,0,Abando,163,83,80,45.91549295774648
Teatro,Teatro Campos Elíseos,991,32.0,1,Indautxu,802,394,408,80.92835519677094
Teatro,Pabellón Número 6,1274,31.13,0,Abando,1034,470,564,81.16169544740973
Concierto,Filarmónica de Bilbao,1533,50.9,0,Casco Viejo,933,520,413,60.861056751467714
Monólogo,Teatro Campos Elíseos,309,12.06,0,Deusto,211,113,98,68.28478964401295
Concierto,Filarmónica de Bilbao,242,19.26,0,Indautxu,126,66,60,52.066115702479344
Monólogo,Teatro Campos Elíseos,427,12.5,0,Abando,354,185,169,82.90398126463701
Monólogo,Teatro Campos Elíseos,1577,54.55,0,Casco Viejo,963,425,538,61.06531388712746
Teatro,Teatro Campos Elíseos,863,47.87,0,San Francisco,373,223,150,43.22132097334878
Musical,Teatro Campos Elíseos,886,39.04,0,Casco Viejo,676,271,405,76.2979683972912
Concierto,Filarmónica de Bilbao,756,55.59,0,Casco Viejo,593,259,334,78.43915343915344
Teatro,Teatro Campos Elíseos,873,23.94,1,Abando,674,293,381,77.20504009163804
Musical,Teatro Campos Elíseos,1093,49.35,0,San Francisco,527,214,313,48.21591948764868
Teatro,Pabellón Número 6,300,45.76,0,Indautxu,226,127,99,75.33333333333333
Teatro,Teatro Campos Elíseos,1578,28.33,0,San Francisco,979,407,572,62.040557667934095
Concierto,Filarmónica de Bilbao,1473,53.62,0,Casco Viejo,1086,596,490,73.72708757637476
Teatro,Pabellón Número 6,1465,25.85,0,Abando,736,297,439,50.23890784982935
Concierto,Filarmónica de Bilbao,225,46.56,1,San Francisco,126,73,53,56.00000000000001
Teatro,Pabellón Número 6,304,28.73,0,Deusto,160,80,80,52.63157894736842
Musical,Teatro Campos Elíseos,585,23.5,1,Casco Viejo,312,172,140,53.333333333333336
Concierto,Filarmónica de Bilbao,1103,12.97,0,San Francisco,473,235,238,42.883046237534
Teatro,Teatro Campos Elíseos,664,26.96,1,Deusto,540,231,309,81.32530120481928
Teatro,Pabellón Número 6,1055,45.2,0,Deusto,792,338,454,75.07109004739337
Concierto,Filarmónica de Bilbao,591,34.4,1,San Francisco,286,129,157,48.39255499153977
Teatro,Pabellón Número 6,411,40.61,1,San Francisco,308,160,148,74.93917274939173
Teatro,Teatro Campos Elíseos,919,37.85,0,Deusto,703,386,317,76.4961915125136
Teatro,Pabellón Número 6,647,49.63,1,San Francisco,375,195,180,57.95981452859351
Teatro,Pabellón Número 6,1551,28.47,0,Deusto,996,419,577,64.21663442940039
Concierto,Filarmónica de Bilbao,1247,57.5,0,Abando,915,404,511,73.37610264635124
Concierto,Filarmónica de Bilbao,1731,18.57,0,Indautxu,1355,692,663,78.27845176198728
Concierto,Filarmónica de Bilbao,331,33.77,0,Abando,182,93,89,54.98489425981873
Teatro,Teatro Campos Elíseos,1247,53.9,1,Casco Viejo,760,403,357,60.94627105052125
Teatro,Pabellón Número 6,871,34.21,0,San Francisco,773,407,366,88.74856486796784
Teatro,Pabellón Número 6,1653,43.35,0,Indautxu,1283,615,668,77.61645493042953
Concierto,Filarmónica de Bilbao,1424,30.7,0,Casco Viejo,1054,529,525,74.01685393258427
Teatro,Pabellón Número 6,474,47.37,0,Abando,243,144,99,51.26582278481012
Concierto,Filarmónica de Bilbao,902,42.07,0,Indautxu,713,300,413,79.04656319290466
Concierto,Filarmónica de Bilbao,1183,25.59,0,Casco Viejo,765,329,436,64.66610312764159
Concierto,Filarmónica de Bilbao,630,30.96,0,Indautxu,417,202,215,66.19047619047619
Teatro,Pabellón Número 6,779,46.42,0,Abando,620,345,275,79.58921694480102
Teatro,Teatro Campos Elíseos,407,22.18,0,Indautxu,263,118,145,64.61916461916462
Teatro,Pabellón Número 6,1577,25.26,0,Indautxu,642,352,290,40.71020925808497
Teatro,Pabellón Número 6,922,56.67,0,San Francisco,527,224,303,57.1583514099783
Teatro,Teatro Campos Elíseos,1088,25.74,0,Deusto,812,362,450,74.63235294117648
Teatro,Pabellón Número 6,1062,21.99,0,Deusto,459,194,265,43.22033898305085
Teatro,Teatro Campos Elíseos,1692,17.54,0,Deusto,896,366,530,52.95508274231678
Teatro,Pabellón Número 6,729,43.31,1,Casco Viejo,319,162,157,43.75857338820302
Concierto,Filarmónica de Bilbao,1641,56.72,0,Abando,980,520,460,59.71968312004875
Teatro,Pabellón Número 6,431,54.05,0,San Francisco,346,194,152,80.2784222737819
Teatro,Pabellón Número 6,1064,41.09,0,Casco Viejo,871,423,448,81.8609022556391
Concierto,Filarmónica de Bilbao,1226,40.23,0,Deusto,593,310,283,48.368678629690045
Monólogo,Teatro Campos Elíseos,1640,40.49,1,San Francisco,1063,520,543,64.8170731707317
Concierto,Filarmónica de Bilbao,598,19.81,0,San Francisco,256,131,125,42.80936454849498
Musical,Teatro Campos Elíseos,1190,20.81,0,Abando,633,324,309,53.19327731092437
Teatro,Pabellón Número 6,803,12.82,1,Deusto,463,215,248,57.65877957658779
Teatro,Teatro Campos Elíseos,216,47.82,0,Deusto,91,37,54,42.129629629629626
Concierto,Filarmónica de Bilbao,1425,41.19,0,San Francisco,614,353,261,43.08771929824562
Concierto,Filarmónica de Bilbao,495,50.31,0,Indautxu,259,124,135,52.323232323232325
Teatro,Teatro Campos Elíseos,819,33.17,0,Abando,496,246,250,60.56166056166056
Teatro,Pabellón Número 6,1341,28.57,0,Casco Viejo,674,281,393,50.26099925428784
Teatro,Pabellón Número 6,1002,38.36,0,Abando,869,516,353,86.72654690618764
Concierto,Filarmónica de Bilbao,1354,42.78,0,Deusto,787,375,412,58.12407680945347
Concierto,Filarmónica de Bilbao,244,59.28,1,Abando,116,52,64,47.540983606557376
Teatro,Pabellón Número 6,1788,29.88,0,San Francisco,716,329,387,40.044742729306485
